..I........I...
....II.....II..
.....I.........
.........zZ....
...IIIII.......
.......I....I..
....I.......I..
....II......I..
...............
.I.....I.......
.I.....I.......
II.....I.......
.......II..II..
..III.......I..
............I..
350 5 5