..I............
..I............
..II...........
.........I.....
.........I.....
.........I.....
.IIIII...I.....
............Z..
............z..
...............
...............
..II...........
..I...III..II..
........I..I...
...........I...
400 6 10