......I...I....
.I........I....
.IIIIII...I....
......I...III..
..I.....I......
..IIIII.II.....
....zZ.........
..II....IIIII..
..I............
.......I......I
IIIII..I....I..
....I..II...I..
...............
.I...II........
......I....II..
300 4 5