..l........l...
....ll.....ll..
.....l.........
...............
...lllll.......
.......l....l..
....l.......l..
....ll......l..
...............
.l.....l.......
.l.....l.......
ll.....l.......
.......ll..ll..
..lll.......l..
.........e..l..