..l............
..l............
..ll..........e
.........l.....
.........l.....
.........l.....
.lllll...l.....
...............
...............
...............
...............
..ll...........
..l...lll..ll..
........l..l...
...........l...