......l...l....
.l........l....
.llllll...l....
......l...lll..
..l.....l......
..lllll.ll.....
...............
..ll....lllll..
e.l............
.......l......l
lllll..l....l..
....l..ll...l..
...............
.l...ll........
......l....ll..